R 5000 5000
C 100,100,100
F 10,10,10
NO ./textures/miniman.xpm
WE ./textures/miniman.xpm
SO ./textures/miniman.xpm
EA ./textures/miniman.xpm
S ./textures/miniman.xpm
11111111111111111
10000000000000001
10000000000000001
10000000002000001
10000000000000001
10000000000000001
1E000000000000001
11111111111111111