         R        500       500
NO ./textures/try.xpm
SO ./textures/try2.xpm
WE ./textures/try3.xpm

EA ./textures/unnamed.xpm
S ./textures/knight.xpm




F         60       ,  90      ,  10

   C    51      ,      100   ,       255
            11111111111111111   1111111
111111111111110000000000000021   10001
100000000000000011111000111111  111111
10000000000000001   10001
1000000000000000011100001
1000000000000000000000001
1000000000000000000000001
1000000000000000000000001
1000000000000000000000001
1000000000000000000000001
1000000000002000000000001
1000000000002000000000001
1111111111111111111111111


1111111111111111111111111
100000000002200000000001
100000000022200000000001
1000000000202000000000001
100000000E022000000000001
100000000022200000000001
100000000002200000000001
1000000000022000000000001
11111000000020111000000011111
    1000000000111000000000001
11111000000000111000000011111
1000000000000000000000001
1000000000000000000000001
1111111111111111111111111
