R 2000 2000

NO ./textures/try.xpm
SO ./textures/try2.xpm
WE ./textures/try3.xpm
EA ./textures/unnamed.xpm
S ./textures/knight.xpm


F 100, 100, 100
C 225,  30, 10
111111111
10000001
100020001
100000001
1020N0201
100000001
100020001
100000001
111111111
